=StartUpServlet
signInPage=signin.html
signInFail=signin.jsp
signIn=SignInServlet
searchPage=search.jsp
signOut=SignOutServlet
search=SearchServlet
adminPage=admin.jsp
loadCakes=LoadCakesServlet
updatePage=update.jsp
renderUpdate=RenderUpdatePageServlet
errorAdminPage=erroradmin.jsp
updateCake=UpdateCakeServlet
updateError=updateinvalid.jsp
createPage=create.jsp
createCake=CreateCakeServlet
createError=createinvalid.jsp
addToCart=AddToCartServlet
viewCart=cart.jsp
updateCart=UpdateCartServlet
deleteCart=DeleteCartSerlvet
checkoutPage=checkout.jsp
checkout=CheckoutServlet
checkoutError=checkoutinvalid.jsp
checkoutSuccess=trackingorder.jsp
errorPage=error.jsp
sendMomoPayment=SendMomoPaymentServlet
processMomoPayment=ProcessMomoPaymentServlet
trackOrder=TrackOrderServlet
trackOrderPage=trackingorder.jsp
signInGoogle=SignInGoogleServlet
sendNganLuongPayment=SendNganLuongPaymentServlet
processNganLuongPayment=ProcessNganLuongPaymentServlet
processNganLuongCancel=ProcessNganLuongCancelServlet
proccessError=ProcessErrorServlet